01111111111111111111111111111111111111111111#111111111111111
10100111111100101$010111110000001111001110010000111010001111
1010111111100101$0101111100000011110011100100001110100011111
101011111110010100100111001111011111011101110000000110111111
101011101111001000*00000000101000100001110011111000*10001001
110100100001011111111100000001010000100011011001001010110001
11100000000011111111100101001011+001010000110011110100011001
100010011100001111111001010110110011111011001011110000000011
100110110001100011101000010000110001111010001011110001100011
100110000000100110000011000110100000011010111110111010011001
10011100100000010000011000010000010001001001110011101$001101
1*00110110011110011001001011*0000101110000110001110011100101
100011010001100000000100100001110000111000000000110011110101
100000010001111110000000000101110000000011000111100000010101
11100000001111111001100010010111100100000101$111101100000001
100000101000011110011011100100010011001001011110001001100011
111101111100111111011011000011000010011011001110000000011011
110*111011010000110$1010000000000010110000000011001100010011
100010001101000011101010111111110100000001100001001100000001
100100100000010011100010000010000111111000110000011100011111
100000111000110011100110000001101100011100011101010001101001
110000011000110000100010101101000001111000000001011000001011
11111100001110000000001$100000000000000001100001010011001011
111111111111111111111111111111111111111111111111111111111111
